Level 2
######
#    #
#  @ #
# $* #
# .* #
#    #
######

Level 3
  ####
###  ####
#     $ #
#     $ #
# . .#@ #
#########
